#########################           ####################
# #         #           #          #                    #
# #         #                      #            ########
# #         #           #                               #
# #  ###    #           #                       ########
# #    #    #########   #          #                    #
# ###  #                #          #            ########
#      #               #           #                    #
# ######              #             ####################
#                    #
#                   #
#                  #
# #################
