##########################
#  #         #           #
#  #         #
#  #         #           #
#  #  ###    #           #
#  #    #    #########   #
#  ###  #                #
#       #               #
#########              #
#                     #
#                    #
#                   #
####################
