#########################
# #         #           #
# #         #
# #         #           #
# #  ###    #           #
# #    #    #########   #
# ###  #                #
#      #               #
########              #
#                    #
#                   #
#                  #
###################
